###            ...   ###....######               ..  ##        ........................###      
###                  ###...   ####               ..  ##         ............       ....###      
##                   ##...     ###               ..  ###         ..........         ...##       
##                   ....      ...              ...  ###         ###.......                     
#                    ..        ........##       ...  ###        #####.....                      
                    ##         ........###      ###  ####       #######                   ..    
               .....#             .....###     ####   #####     #######       ####       ....   
           ###.....                ....###     ###     ######......#####      ####     ......   
           ####.           O       ....##      ##        ####.......#####     ####    ##....    
            ###                    .....      ###         ## .......########   ##     ###..     
            ###          ###       .....      ###.            ...... ########         ####      
             ##          ####      ....      .......           ....   ########        ####      
             ##   ...    ####      ...      ........   ..       ..        ####       .####      
            ..    ....    ###.    ...      .........   ...                 ####     ...###      
##...      ...  ##.....   .....   ...     ....         ....                #####     .####      
##....    ...   ###...#........######    ....          ......             #######    ######  ...
##...........   ###...##.......######    ...           .......            #######     ######....
##...........      ...###......######    ...           ......###        ...#####       ######.  
##..........        ..###      ####### ##...    ..      ....#####      ....            ######   
##......                        ##########.             ....####        ..             #####    
###....                         ##########              ....                           #####    
####...                         ..########               ..                            ......   
#####...                         .########                      .      #              ........  
  ###....##     ######            #####.......                 ...    ###       .    .........  
     .....     ########    ..      #   ........     ##         ........###     ....##.........  
     .....     ########                ........     ###         ###.....##      ...##........   
     .....     #######           ..    ........     ##          ####......            ....      
      ...     ########          ....   .......           .      #####......                     
             ########..         ......##....            ...     #####.......                    
            ####  ###..          ..........    ####     ...     #####.......                    
           ####    ###.          ..........   ######     ...   ######.....   #                  
..      ######               ####..............#####.    ...########.....    ...                
...    ######               ######..   ........####...  ....########....     ...                
..    ######               ######       ........###..........###### ...      ...                
     #######              ..####        ####.....###.........#####          #...                
     #######             ....         #######....###  ......#####          ###...               
      ######          .......         #########..###   ..   #####          ####..               
       #####         ...##...         ##########.#           ####           ###..               
       .###           .####.           ##########            .####          ###.              . 
      ...##            ####            #######           ###.......          ##              ...
.     ..###            ###             ######           ###........          ..              ...
..     ####           ####             #####...         ###.......           ..               ..
..     ###            #####            ####.....      X ####.....            ...              ..
.##                 ..#####             ##  ....        ####.....       ###   .##              .
####                ...#####                 ...         ###....        ####   ####             
####          .     ...#####                  ..          .....         #####  #######          
####         ...     .#######                 ..##        ....          #####  ########   #     
####         ...      #######                  .###...     ...          ###### ########  ###    
