.......    ...  ##############     #######     #####   ....#####
.......    ...  ##############    ########      ###     ..######
.......         ###############   #######                 ######
........        ################ ####                           
####....         ###################                            
#####...         .#####...   #######   ##                       
######...        ..##  ..     #####   #####                     
    ###...                     ####  #######                  ..
     ##....                     ##   ########                ...
        .... O                  ##   ########               ....
         .......                ###  #######                ....
          ...........           ####  #....                  ...
     #     ............        #####  ....                      
     ##    .................   ####   ....                      
     #     .....     ..........##### ....                       
           ....        #####..######....                       #
            ..         #############...                       ##
               ...      ############..                       .##
         ..   .....        #########..                      ...#
     ###....  .....        ######## .                       ..  
....####....  .....        ######                    ...  ###   
....#####..    ....        #####                ...  ....#####  
....#####..     ..         #####           ..   ...   ..######  
  ..#####.                  #####         .... X .     ######...
    ####..                  ######   ##  .....         #####....
     ##...                  ####### ........##         #####....
      #...                  ########........###        #####....
       ...                  ##########.. ...#####      #####....
      ....                   ##   #####   ..####        ####....
      .....                        ####   ..###             ....
      ......                        ##     ###               ...
       ......                       ##     ###                ..
