  ..###    ####    ......    ...
##..##   O ####    ......    ...
##..##    ####      ....     ...
##..###  ####       ...     ....
    ##.  ####      ....    .....
     ...  ###      .....   .....
      .            .............
      #           ####..........
     ###         ##### .........
    #####       #####     ... X 
    ######       ###            
    #######                     
     ######                     
      #####               ###   
      ######            ...###..
      #########         ...###..
